30
13
2,2,2,2,2,2,2,2,2,2,2,2,2,2,2,2,2,2,2,2,2,2,2,2,2,2,2,2,2,2
2,2,2,2,2,2,0,0,0,2,0,0,0,2,0,0,0,2,4,0,2,2,2,2,2,2,2,2,2,2
2,2,2,2,2,2,0,2,0,2,0,2,0,2,0,2,0,2,4,4,5,0,0,0,0,0,0,0,0,2
2,2,2,4,2,2,0,2,0,2,0,2,0,2,0,2,0,2,0,0,2,2,2,2,2,2,2,2,0,2
2,2,0,0,0,0,0,2,0,0,0,2,0,0,0,2,0,0,0,4,0,0,0,0,0,0,0,0,0,2
2,s,0,2,2,2,2,2,2,2,2,2,2,2,2,2,2,2,2,2,2,2,2,2,2,2,2,2,0,2
2,2,0,2,2,2,2,2,4,2,2,2,0,0,0,0,0,0,0,0,0,0,0,0,0,0,0,0,0,2
2,2,0,0,0,2,0,0,0,0,0,2,4,4,4,4,4,4,4,4,2,2,2,2,2,2,2,2,0,2
2,2,0,2,2,2,0,0,2,2,0,5,0,0,0,0,0,0,0,0,0,0,0,0,0,0,0,0,0,2
2,2,0,0,0,2,0,0,0,0,0,2,4,0,4,0,4,0,4,0,2,2,2,2,2,2,2,3,0,2
2,2,0,2,0,2,0,2,0,2,2,2,0,4,0,5,0,4,0,3,2,2,2,2,2,0,0,0,0,2
2,2,0,0,0,0,0,2,5,2,2,2,0,0,0,0,0,0,0,0,0,0,0,0,0,0,2,2,2,2
2,2,2,2,2,2,2,2,2,2,2,2,2,2,2,2,2,2,2,2,2,2,2,2,2,2,2,2,2,2