21
15
2,2,2,2,2,2,2,2,2,2,2,2,2,2,2,2,2,2,2,2,2
2,5,0,5,0,5,4,0,0,0,0,0,0,0,0,0,0,0,0,0,2
2,2,2,2,2,0,4,4,0,0,0,0,0,0,0,0,0,0,0,0,2
2,4,2,4,2,4,4,4,4,0,0,0,0,0,0,0,0,0,0,0,2
2,1,2,1,2,1,2,2,2,0,0,0,0,0,0,0,0,0,0,0,2
2,1,2,1,2,1,0,0,0,0,0,0,0,0,0,2,0,2,0,0,2
2,1,2,1,2,1,2,0,0,0,0,0,0,0,0,0,3,0,0,0,2
2,1,2,1,2,1,2,0,0,0,0,0,0,0,0,2,0,2,0,0,2
2,1,2,1,2,1,2,0,0,0,0,0,0,0,0,0,0,0,0,0,2
2,1,2,1,2,1,2,0,0,2,2,2,0,0,0,0,0,0,0,0,2
2,1,2,1,2,1,2,2,2,2,4,4,0,0,0,0,0,0,0,0,2
2,1,1,1,2,1,0,0,0,4,0,0,0,0,0,0,0,0,0,0,2
2,1,2,1,2,1,4,4,4,0,0,2,0,0,0,0,0,0,0,0,2
2,s,2,1,1,1,0,0,0,0,2,2,0,0,0,0,0,0,0,0,2
2,2,2,2,2,2,2,2,2,2,2,2,2,2,2,2,2,2,2,2,2