21
15
2,2,2,2,2,2,2,2,2,2,2,2,2,2,2,2,2,2,2,2,2
2,2,4,2,2,2,0,0,0,0,0,0,0,0,0,0,0,0,0,0,2
2,0,5,0,0,2,4,0,4,0,4,0,4,0,0,0,0,0,0,0,2
2,0,2,0,0,0,0,0,0,0,0,0,0,0,3,0,0,0,0,0,2
2,0,0,0,0,2,0,4,0,4,0,4,0,4,0,0,0,0,0,0,2
2,0,0,0,2,2,0,0,0,0,0,0,0,0,0,0,0,0,0,0,2
2,2,0,2,2,2,0,2,2,2,2,4,4,4,4,4,4,4,4,4,2
2,2,0,2,2,0,0,2,0,0,s,0,0,0,0,0,0,0,0,5,2
2,0,0,0,0,2,0,2,0,2,2,2,2,2,2,2,2,2,2,0,2
2,2,2,2,0,2,0,2,0,0,0,2,0,0,0,0,0,0,0,0,2
2,5,0,0,0,2,2,2,2,2,0,2,0,2,2,2,2,2,2,2,2
2,2,2,2,0,0,0,2,0,2,0,2,0,2,1,1,1,1,1,1,2
2,4,0,0,0,2,0,0,0,2,0,2,0,2,1,1,1,1,1,1,2
2,0,0,2,0,0,0,2,0,5,0,0,0,2,1,1,1,1,1,1,2
2,2,2,2,2,2,2,2,2,2,2,2,2,2,2,2,2,2,2,2,2