21
17
2,2,2,2,2,2,2,2,2,2,2,2,2,2,2,2,2,2,2,2,2
2,4,2,0,0,0,0,0,0,0,0,0,0,0,0,0,0,0,0,0,2
2,1,2,0,0,0,0,0,0,0,0,0,0,0,0,0,0,0,0,0,2
2,1,2,0,0,0,0,0,0,0,0,s,0,0,0,0,0,0,0,0,2
2,1,2,0,0,0,0,0,0,0,0,0,0,0,0,0,0,0,0,0,2
2,1,2,0,0,0,0,0,0,0,0,0,0,2,2,2,4,2,0,0,2
2,1,2,0,0,0,0,0,0,0,0,0,0,2,0,0,0,2,0,0,2
2,1,2,0,0,0,0,0,0,0,0,0,0,2,0,2,1,2,0,0,2
2,1,2,4,4,4,4,4,4,0,0,0,0,2,0,2,1,2,0,0,2
2,1,0,0,5,5,5,5,5,0,0,0,0,2,0,2,1,2,0,0,2
2,1,2,0,4,4,4,4,4,0,0,0,0,0,0,2,1,2,0,0,2
2,1,2,0,0,0,0,0,0,0,0,0,2,2,2,2,3,2,0,0,2
2,1,2,0,0,0,0,0,0,0,0,0,0,0,0,0,0,0,0,0,2
2,1,2,0,0,0,0,0,0,0,0,0,0,0,0,0,0,0,0,0,2
2,1,2,2,2,2,2,2,2,2,2,2,2,2,2,2,2,2,2,2,2
2,1,2,2,2,2,2,2,2,2,2,2,2,2,2,2,2,2,2,2,2
2,2,2,2,2,2,2,2,2,2,2,2,2,2,2,2,2,2,2,2,2