21
15
2,2,2,2,2,2,2,2,2,2,2,2,2,2,2,2,2,2,2,2,2
2,0,0,0,0,0,0,0,2,2,2,0,0,2,0,2,0,0,0,0,2
2,0,0,0,0,0,0,0,4,2,5,1,1,0,0,2,0,0,0,0,2
2,0,0,0,0,0,0,0,2,2,2,1,1,2,0,2,0,0,0,0,2
2,0,0,0,0,0,0,0,0,2,1,1,1,2,0,2,0,0,0,0,2
2,0,0,0,0,0,0,2,2,0,2,2,1,2,0,2,0,0,0,0,2
2,0,2,2,2,2,2,2,2,0,2,2,2,2,0,2,0,0,0,0,2
2,0,2,0,0,0,0,0,0,s,0,0,0,0,0,2,0,0,0,0,2
2,0,2,0,0,2,2,2,2,0,2,2,2,2,2,2,0,0,0,0,2
2,0,2,0,2,1,1,2,2,0,2,2,0,0,0,0,0,0,0,0,2
2,0,2,0,2,1,1,0,2,0,2,0,0,0,0,0,0,0,0,0,2
2,0,2,0,2,1,1,2,2,0,2,2,0,0,0,0,0,0,0,0,2
2,0,2,5,2,1,2,0,0,0,0,0,2,0,0,0,0,0,0,0,2
2,0,0,2,1,1,2,0,0,3,0,0,2,0,0,0,0,0,0,0,2
2,2,2,2,2,2,2,2,2,2,2,2,2,2,2,2,2,2,2,2,2