21
13
2,2,2,2,2,2,2,2,2,2,2,2,2,2,2,2,2,2,2,2,2
2,0,0,0,0,0,0,0,0,0,0,0,0,0,0,0,0,0,0,0,2
2,0,5,0,0,0,0,0,0,0,0,0,0,0,0,0,0,0,0,0,2
2,0,1,0,0,0,s,0,0,0,0,0,0,0,0,0,0,0,0,0,2
2,1,4,1,0,0,0,0,0,0,0,0,0,0,0,0,0,0,0,0,2
2,1,5,1,0,0,0,0,0,0,0,0,0,0,0,0,0,0,0,0,2
2,1,1,1,0,0,0,0,0,0,0,0,0,0,0,0,0,0,0,0,2
2,1,4,1,0,0,0,0,0,0,0,0,0,0,0,0,0,0,0,0,2
2,4,5,4,0,0,0,0,0,0,0,0,0,0,0,0,0,0,0,0,2
2,0,0,0,0,0,0,0,0,0,0,0,0,0,0,0,0,0,0,0,2
2,0,0,0,0,0,0,0,0,0,0,0,0,0,0,0,0,0,0,0,2
2,0,0,0,0,0,0,0,0,0,0,0,0,0,0,0,0,0,0,0,2
2,2,2,2,2,2,2,2,2,2,2,2,2,2,2,2,2,2,2,2,2